1
0
9
0   600   0   -100   0   0   0   -100   0   0   0
1   600   100   0   -100   0   0   0   0   0   0
2   600   0   100   0   -100   0   0   0   0   0
3   600   0   0   100   0   -100   0   0   0   0
4   600   0   0   0   100   0   0   0   0   0
5   600   100   0   0   0   0   0   -100   0   0
6   600   0   0   0   0   0   100   0   -100   0
7   600   0   0   0   0   0   0   100   0   -100
8   600   0   0   0   0   0   0   0   100   0	
