1
0
9
0   400   0   -200   -200   -200   0   0   0   0   0
1   400   300   0   0   0   -300   -300   0   0   0
2   400   300   0   0   0   0   0   -300   -300   0
3   400   300   0   0   0   0   0   0   0   -300
4   400   0   300   0   0   0   0   0   0   0
5   400   0   300   0   0   0   0   0   0   0
6   400   0   0   300   0   0   0   0   0   0
7   400   0   0   300   0   0   0   0   0   0
8   400   0   0   0   300   0   0   0   0   0

