1
0
9
0   300   0   -100   -100   -100   -100   -100   -100   -100   -100
1   600   100   0   0   0   0   0   0   0   0
2   600   100   0   0   0   0   0   0   0   0
3   600   100   0   0   0   0   0   0   0   0
4   600   100   0   0   0   0   0   0   0   0
5   700   100   0   0   0   0   0   0   0   0
6   800   100   0   0   0   0   0   0   0   0
7   800   100   0   0   0   0   0   0   0   0
8   600   100   0   0   0   0   0   0   0   0	

