1
0
9
0   300   0   -50   0   0   0   0   0   0   0
1   300   50   0   -50   0   0   0   0   0   0
2   200   0   50   0   -50   0   0   0   0   0
3   100   0   0   50   0   -50   0   0   0   0
4   300   0   0   0   50   0   -50   0   0   0
5   400   0   0   0   0   50   0   -50   0   0
6   300   0   0   0   0   0   50   0   -50   0
7   400   0   0   0   0   0   0   50   0   -50
8   300   0   0   0   0   0   0   0   50   0

